"a" = (/turf/simulated/floor/St_Muh_13/digable/grass,/area/St_Muh_13)
"b" = (/turf/simulated/wall/brick_wall_d,/area/St_Muh_13)
"c" = (/obj/structure/ladder/manhole/up,/turf/simulated/floor/St_Muh_13/wood{tag = "icon-plita2"; icon_state = "plita2"},/area/St_Muh_13)
"d" = (/turf/simulated/floor/St_Muh_13/wood{tag = "icon-plita2"; icon_state = "plita2"},/area/St_Muh_13)
"e" = (/turf/simulated/floor/St_Muh_13/wood{tag = "icon-plita1"; icon_state = "plita1"},/area/St_Muh_13)
"f" = (/turf/simulated/floor/St_Muh_13/wood{tag = "icon-plita3"; icon_state = "plita3"},/area/St_Muh_13)
"g" = (/turf/simulated/floor/St_Muh_13/water{tag = "icon-default"; icon_state = ""},/area/St_Muh_13)
"h" = (/turf/simulated/floor/St_Muh_13/wood{tag = "icon-plita4"; icon_state = "plita4"},/area/St_Muh_13)
"i" = (/obj/structure/ladder/manhole/up,/turf/simulated/floor/St_Muh_13/wood{tag = "icon-plita3"; icon_state = "plita3"},/area/St_Muh_13)

(1,1,1) = {"
aaaaaaaaaaaaaaaaaaaaaaaaaaaaaaaaaaaaaaaaaaaaaaaaaa
aaaaaaaaaaaaaaaaaaaaaaaaaaaaaaaaaaaaaaaaaaaaaaaaaa
aaaaaaaaaaaaaaaaaaaaaaaaaaaaaaaaaaaaaaaaaaaaaaaaaa
aaaaaaaaaaaaaaaaaaaaaaaaaaaaaaaaaaaaaaaaaaaaaaaaaa
aaaaaaaaaaaaaaaaaaaaaaaaaaaaaaaaaaaaaaaaaaaaaaaaaa
aaaaaaaaaaaaaaaaaaaaaaaaaaaaaaaaaaaaaaaaaaaaaaaaaa
aaaaaaaaaaaaaaaaaaaaaaaaaaaaaaaaaaaaaaaaaaaaaaaaaa
aaaaaaaaaaaaaaaaaaaaaaaaaaaaaaaaaaaaaaaaaaaaaaaaaa
aaaaaaaaaaaaaaaaaaaaaaaaaaaaaaaaaaaaaaaaaaaaaaaaaa
aaaaaaaaaaaaaaaaaaaaaaaaaaaaaaaaaaaaaaaaaaaaaaaaaa
aaaaaaaaaaaaaaaaaaaaaaaaaaaaaaabbbaaaaaaaaaaaaaaaa
aaaaaaaaaaaaaaaaaaaaaaaaaaaabbbbcbbbbaaaaaaaaaaaaa
aaaaaaaaaaaaaaaaaaaaaaaaaaaabddeddddbaaaaaaaaaaaaa
aaaaaaaaaaaaaaaaaaaaaaaaaaaabdfdffdebaaaaaaaaaaaaa
aaaaaaaaaaaaaaaaaaaaaaaaaaaabddgggddbaaaaaaaaaaaaa
aaaaaaaaaaaaaaaaaaaaaaaaaaaabedgggedbaaaaaaaaaaaaa
aaaaaaaaaaaaaaaaaaaaaaaaaaaabfddgddebaaaaaaaaaaaaa
aaaaaaaaaaaaaaaaaaaaaaaaaaaabhfhgehhbaaaaaaaaaaaaa
aaaaaaaaaaaaaaaabbbbbbbbbaaabbdegeebbaaaaaaaaaaaaa
aaaaaaaaaaaaaaabbddddeddbbaaabeegeebaaaaaaaaaaaaaa
aaaaaaaaaaaaaaabeedddedddbbaabffgffbaaaaaaaaaaaaaa
aaaaaaaaaaaaaaabeeegggddddbbabffgffbaaaaaaaaaaaaaa
aaaaaaaaaaaaaaabeeggggghfefbbbffgffbaaaaaaaaaaaaaa
aaaaaaaaaaaaaaabeeggggggfefffffegffbaaaaaaaaaaaaaa
aaaaaaaaaaaaaaabeegggbgggfehfeffgeebaaaaaaaaaaaaaa
aaaaaaaaaaaaaaabeeeggggggggggggggeebaaaaaaaaaaaaaa
aaaaaaaaaaaaaaabefeegggggggeffehhhebaaaaaaaaaaaaaa
aaaaaaaaaaaaaaabbdeeegggggggeehhdfebaaaaaaaaaaaaaa
aaaaaaaaaaaaaaaabbeeeegggbgggeebbbbbaaaaaaaaaaaaaa
aaaaaaaaaaaabbbbbbehfegggggggefbaaaaaaaaaaaaaaaaaa
aaaaaaaaaaaabdeddedeeegegggggffbaaaaaaaaaaaaaaaaaa
aaaaaaaaaaaabhffeefegggddgggefebaaaaaaaaaaaaaaaaaa
aaaaaaaaaaaabefggggggeededddeeebaaaaaaaaaaaaaaaaaa
aaaaaaaaaaaabefgeeeddeeedhheeebbaaaaaaaaaaaaaaaaaa
aaaaaaaaaaaabegggedfdeebbbbbbbbaaaaaaaaaaaaaaaaaaa
aaaaaaaaaabbbegggeeebbbbaaaaaaaaaaaaaaaaaaaaaaaaaa
aaaaaaaaaabibeehfeebbaaaaaaaaaaaaaaaaaaaaaaaaaaaaa
aaaaaaaaaabhfffdeeebaaaaaaaaaaaaaaaaaaaaaaaaaaaaaa
aaaaaaaaaabffddhbbbbaaaaaaaaaaaaaaaaaaaaaaaaaaaaaa
aaaaaaaaaabfddhhbaaaaaaaaaaaaaaaaaaaaaaaaaaaaaaaaa
aaaaaaaaaabbbbbbbaaaaaaaaaaaaaaaaaaaaaaaaaaaaaaaaa
aaaaaaaaaaaaaaaaaaaaaaaaaaaaaaaaaaaaaaaaaaaaaaaaaa
aaaaaaaaaaaaaaaaaaaaaaaaaaaaaaaaaaaaaaaaaaaaaaaaaa
aaaaaaaaaaaaaaaaaaaaaaaaaaaaaaaaaaaaaaaaaaaaaaaaaa
aaaaaaaaaaaaaaaaaaaaaaaaaaaaaaaaaaaaaaaaaaaaaaaaaa
aaaaaaaaaaaaaaaaaaaaaaaaaaaaaaaaaaaaaaaaaaaaaaaaaa
aaaaaaaaaaaaaaaaaaaaaaaaaaaaaaaaaaaaaaaaaaaaaaaaaa
aaaaaaaaaaaaaaaaaaaaaaaaaaaaaaaaaaaaaaaaaaaaaaaaaa
aaaaaaaaaaaaaaaaaaaaaaaaaaaaaaaaaaaaaaaaaaaaaaaaaa
aaaaaaaaaaaaaaaaaaaaaaaaaaaaaaaaaaaaaaaaaaaaaaaaaa
"}

(1,1,2) = {"
aaaaaaaaaaaaaaaaaaaaaaaaaaaaaaaaaaaaaaaaaaaaaaaaaa
aaaaaaaaaaaaaaaaaaaaaaaaaaaaaaaaaaaaaaaaaaaaaaaaaa
aaaaaaaaaaaaaaaaaaaaaaaaaaaaaaaaaaaaaaaaaaaaaaaaaa
aaaaaaaaaaaaaaaaaaaaaaaaaaaaaaaaaaaaaaaaaaaaaaaaaa
aaaaaaaaaaaaaaaaaaaaaaaaaaaaaaaaaaaaaaaaaaaaaaaaaa
aaaaaaaaaaaaaaaaaaaaaaaaaaaaaaaaaaaaaaaaaaaaaaaaaa
aaaaaaaaaaaaaaaaaaaaaaaaaaaaaaaaaaaaaaaaaaaaaaaaaa
aaaaaaaaaaaaaaaaaaaaaaaaaaaaaaaaaaaaaaaaaaaaaaaaaa
aaaaaaaaaaaaaaaaaaaaaaaaaaaaaaaaaaaaaaaaaaaaaaaaaa
aaaaaaaaaaaaaaaaaaaaaaaaaaaaaaaaaaaaaaaaaaaaaaaaaa
aaaaaaaaaaaaaaaaaaaaaaaaaaaaaaaaaaaaaaaaaaaaaaaaaa
aaaaaaaaaaaaaaaaaaaaaaaaaaaaaaaaaaaaaaaaaaaaaaaaaa
aaaaaaaaaaaaaaaaaaaaaaaaaaaaaaaaaaaaaaaaaaaaaaaaaa
aaaaaaaaaaaaaaaaaaaaaaaaaaaaaaaaaaaaaaaaaaaaaaaaaa
aaaaaaaaaaaaaaaaaaaaaaaaaaaaaaaaaaaaaaaaaaaaaaaaaa
aaaaaaaaaaaaaaaaaaaaaaaaaaaaaaaaaaaaaaaaaaaaaaaaaa
aaaaaaaaaaaaaaaaaaaaaaaaaaaaaaaaaaaaaaaaaaaaaaaaaa
aaaaaaaaaaaaaaaaaaaaaaaaaaaaaaaaaaaaaaaaaaaaaaaaaa
aaaaaaaaaaaaaaaaaaaaaaaaaaaaaaaaaaaaaaaaaaaaaaaaaa
aaaaaaaaaaaaaaaaaaaaaaaaaaaaaaaaaaaaaaaaaaaaaaaaaa
aaaaaaaaaaaaaaaaaaaaaaaaaaaaaaaaaaaaaaaaaaaaaaaaaa
aaaaaaaaaaaaaaaaaaaaaaaaaaaaaaaaaaaaaaaaaaaaaaaaaa
aaaaaaaaaaaaaaaaaaaaaaaaaaaaaaaaaaaaaaaaaaaaaaaaaa
aaaaaaaaaaaaaaaaaaaaaaaaaaaaaaaaaaaaaaaaaaaaaaaaaa
aaaaaaaaaaaaaaaaaaaaaaaaaaaaaaaaaaaaaaaaaaaaaaaaaa
aaaaaaaaaaaaaaaaaaaaaaaaaaaaaaaaaaaaaaaaaaaaaaaaaa
aaaaaaaaaaaaaaaaaaaaaaaaaaaaaaaaaaaaaaaaaaaaaaaaaa
aaaaaaaaaaaaaaaaaaaaaaaaaaaaaaaaaaaaaaaaaaaaaaaaaa
aaaaaaaaaaaaaaaaaaaaaaaaaaaaaaaaaaaaaaaaaaaaaaaaaa
aaaaaaaaaaaaaaaaaaaaaaaaaaaaaaaaaaaaaaaaaaaaaaaaaa
aaaaaaaaaaaaaaaaaaaaaaaaaaaaaaaaaaaaaaaaaaaaaaaaaa
aaaaaaaaaaaaaaaaaaaaaaaaaaaaaaaaaaaaaaaaaaaaaaaaaa
aaaaaaaaaaaaaaaaaaaaaaaaaaaaaaaaaaaaaaaaaaaaaaaaaa
aaaaaaaaaaaaaaaaaaaaaaaaaaaaaaaaaaaaaaaaaaaaaaaaaa
aaaaaaaaaaaaaaaaaaaaaaaaaaaaaaaaaaaaaaaaaaaaaaaaaa
aaaaaaaaaaaaaaaaaaaaaaaaaaaaaaaaaaaaaaaaaaaaaaaaaa
aaaaaaaaaaaaaaaaaaaaaaaaaaaaaaaaaaaaaaaaaaaaaaaaaa
aaaaaaaaaaaaaaaaaaaaaaaaaaaaaaaaaaaaaaaaaaaaaaaaaa
aaaaaaaaaaaaaaaaaaaaaaaaaaaaaaaaaaaaaaaaaaaaaaaaaa
aaaaaaaaaaaaaaaaaaaaaaaaaaaaaaaaaaaaaaaaaaaaaaaaaa
aaaaaaaaaaaaaaaaaaaaaaaaaaaaaaaaaaaaaaaaaaaaaaaaaa
aaaaaaaaaaaaaaaaaaaaaaaaaaaaaaaaaaaaaaaaaaaaaaaaaa
aaaaaaaaaaaaaaaaaaaaaaaaaaaaaaaaaaaaaaaaaaaaaaaaaa
aaaaaaaaaaaaaaaaaaaaaaaaaaaaaaaaaaaaaaaaaaaaaaaaaa
aaaaaaaaaaaaaaaaaaaaaaaaaaaaaaaaaaaaaaaaaaaaaaaaaa
aaaaaaaaaaaaaaaaaaaaaaaaaaaaaaaaaaaaaaaaaaaaaaaaaa
aaaaaaaaaaaaaaaaaaaaaaaaaaaaaaaaaaaaaaaaaaaaaaaaaa
aaaaaaaaaaaaaaaaaaaaaaaaaaaaaaaaaaaaaaaaaaaaaaaaaa
aaaaaaaaaaaaaaaaaaaaaaaaaaaaaaaaaaaaaaaaaaaaaaaaaa
aaaaaaaaaaaaaaaaaaaaaaaaaaaaaaaaaaaaaaaaaaaaaaaaaa
"}
