"a" = (/turf/St_Muh_13/floor/digable/grass,/area/St_Muh_13)
"b" = (/turf/simulated/wall,/area/St_Muh_13)
"c" = (/obj/effect/landmark{name = "JoinLate"},/turf/St_Muh_13/floor/plasteel/plitochka,/area/St_Muh_13)
"d" = (/turf/St_Muh_13/floor/plasteel/plita,/area/St_Muh_13)
"e" = (/turf/St_Muh_13/floor/plasteel/plitka,/area/St_Muh_13)
"f" = (/turf/St_Muh_13/floor/gryaz,/area/St_Muh_13)
"g" = (/turf/St_Muh_13/floor/plasteel,/area/St_Muh_13)
"h" = (/obj/effect/landmark{name = "JoinLate"},/turf/St_Muh_13/floor/sidor,/area/St_Muh_13)
"i" = (/obj/item/device/flashlight/lamp/green,/turf/St_Muh_13/floor/tropa,/area/St_Muh_13)
"j" = (/obj/effect/landmark/start,/turf/St_Muh_13/floor/road,/area/St_Muh_13)
"k" = (/obj/item/device/flashlight/lamp,/turf/St_Muh_13/floor/wood,/area/St_Muh_13)
"l" = (/obj/effect/landmark{name = "JoinLate"},/turf/St_Muh_13/floor/wood/oldgor,/area/St_Muh_13)
"m" = (/turf/St_Muh_13/floor/water,/area/St_Muh_13)
"n" = (/turf/St_Muh_13/floor/wood/oldvert,/area/St_Muh_13)
"o" = (/turf/St_Muh_13/floor/agroprom/gryaz,/area/St_Muh_13)
"p" = (/obj/effect/landmark{name = "JoinLate"},/turf/St_Muh_13/floor/agroprom/beton,/area/St_Muh_13)
"q" = (/obj/vehicle/bike/thermal,/turf/St_Muh_13/floor/digable/grass,/area/St_Muh_13)

(1,1,1) = {"
aaaaaaaaaaaaaaaaaaaaaaaaaaaaaaaaaaa
aaaaaaaaaaaaaaaaaaaaaaaaaaaaaaaaaaa
aaaaaaaaaaaaaaaaaaaaaaaaaaaaaaaaaaa
aaaaaaaaaaaaaaaaaaaaaaaaaaaaaaaaaaa
aaaaaaaaaaaaaaaaaaaaaaaaaaaaaaaaaaa
aaaaaaaaaaaaaaaaaaaaaaaaaaaaaaaaaaa
aaaaaaaaaaaaaaaaaaaaaaaaaaaaaaaaaaa
aaaaaaaaaaaaaaaaaaaaaaaaaaaaaaaaaaa
aaaaaaaaaaaaaaaaaaaaaaaaaaaaaaaaaaa
aaaaaaaaaaaaaaaaaaaaaaaaaaaaaaaaaaa
aaaaaaaaaaaaaaaaaaaaaaaaaaaaaaaaaaa
aaaaaaaaaaaaaaaaaaaaaaaaaaaaaaaaaaa
aaaaaaaaaaaaaaaaaaaaaaaaaaaaaaaaaaa
aaaaaaaaaaaaaaaaaaaaaaaaaaaaaaaaaaa
aaaaaaaaaaaaaaaaaaaaaaaaaaaaaaaaaaa
aaaaaaaaaaaaaabbcdbaaaaaaaaaaaaaaaa
aaaaaaaaaaaaaaefgfbaaaaaaaaaaaaaaaa
aaaaaaaaaaaaaahijklaaaaaaaaaaaaaaaa
aaaaaaaaaaaaaabfmfnaaaaaaaaaaaaaaaa
aaaaaaaaaaaaaabopbbaaaaaaaaaaaaaaaa
aaaaaaaaaaaaaaqaaaaaaaaaaaaaaaaaaaa
aaaaaaaaaaaaaaaaaaaaaaaaaaaaaaaaaaa
aaaaaaaaaaaaaaaaaaaaaaaaaaaaaaaaaaa
aaaaaaaaaaaaaaaaaaaaaaaaaaaaaaaaaaa
aaaaaaaaaaaaaaaaaaaaaaaaaaaaaaaaaaa
aaaaaaaaaaaaaaaaaaaaaaaaaaaaaaaaaaa
aaaaaaaabaaaaaaaaaaaaaaaaaaaaaaaaaa
aaaaaaaaaaaaaaaaaaaaaaaaaaaaaaaaaaa
aaaaaaaaaaaaaaaaaaaaaaaaaaaaaaaaaaa
aaaaaaaaaaaaaaaaaaaaaaaaaaaaaaaaaaa
aaaaaaaaaaaaaaaaaaaaaaaaaaaaaaaaaaa
aaaaaaaaaaaaaaaaaaaaaaaaaaaaaaaaaaa
aaaaaaaaaaaaaaaaaaaaaaaaaaaaaaaaaaa
aaaaaaaaaaaaaaaaaaaaaaaaaaaaaaaaaaa
aaaaaaaaaaaaaaaaaaaaaaaaaaaaaaaaaaa
"}
