"aa" = (/turf/simulated/floor/St_Muh_13/digable/grass,/area/St_Muh_13/outdoor)
"ab" = (/turf/simulated/wall/brick_wall,/area/St_Muh_13)
"ac" = (/turf/simulated/floor/St_Muh_13/digable/grass,/area/St_Muh_13)
"ad" = (/obj/machinery/door/unpowered/simple_door,/turf/simulated/floor/St_Muh_13/digable/grass,/area/St_Muh_13)
"ae" = (/obj/machinery/door/unpowered/simple/silver{locked = 0},/turf/simulated/floor/St_Muh_13/digable/grass,/area/St_Muh_13)
"af" = (/obj/machinery/door/unpowered/simple_door,/turf/simulated/wall/brick_wall,/area/St_Muh_13)
"ag" = (/obj/item/weapon/card/id,/turf/simulated/floor/St_Muh_13/digable/grass,/area/St_Muh_13/outdoor)
"ah" = (/obj/structure/St_Muh_13/soil/tropa{tag = "icon-road_s3"; icon_state = "road_s3"},/turf/simulated/floor/St_Muh_13/digable/grass,/area/St_Muh_13/outdoor)
"ai" = (/obj/structure/St_Muh_13/soil/tropa{tag = "icon-road_s33"; icon_state = "road_s33"},/turf/simulated/floor/St_Muh_13/digable/grass,/area/St_Muh_13/outdoor)
"aj" = (/obj/machinery/door/unpowered/simple_door,/turf/simulated/floor/St_Muh_13/digable/grass,/area/St_Muh_13/outdoor)
"ak" = (/obj/structure/St_Muh_13/soil/tropa{tag = "icon-POVOROT2"; icon_state = "POVOROT2"},/turf/simulated/floor/St_Muh_13/digable/grass,/area/St_Muh_13/outdoor)
"al" = (/obj/structure/St_Muh_13/soil/tropa{tag = "icon-road_s3333"; icon_state = "road_s3333"},/turf/simulated/floor/St_Muh_13/digable/grass,/area/St_Muh_13/outdoor)
"am" = (/obj/structure/St_Muh_13/soil/tropa{tag = "icon-POVOROT22"; icon_state = "POVOROT22"},/turf/simulated/floor/St_Muh_13/digable/grass,/area/St_Muh_13/outdoor)
"an" = (/obj/structure/St_Muh_13/soil/tropa{tag = "icon-road14"; icon_state = "road14"},/turf/simulated/floor/St_Muh_13/digable/grass,/area/St_Muh_13/outdoor)
"ao" = (/obj/structure/St_Muh_13/soil/tropa{tag = "icon-road_s333"; icon_state = "road_s333"},/turf/simulated/floor/St_Muh_13/digable/grass,/area/St_Muh_13/outdoor)
"ap" = (/obj/structure/St_Muh_13/soil/tropa{tag = "icon-road13"; icon_state = "road13"},/turf/simulated/floor/St_Muh_13/digable/grass,/area/St_Muh_13/outdoor)
"aq" = (/obj/structure/St_Muh_13/soil/tropa{tag = "icon-road144"; icon_state = "road144"},/turf/simulated/floor/St_Muh_13/digable/grass,/area/St_Muh_13/outdoor)
"ar" = (/obj/structure/St_Muh_13/soil/tropa{tag = "icon-road133"; icon_state = "road133"},/turf/simulated/floor/St_Muh_13/digable/grass,/area/St_Muh_13/outdoor)
"as" = (/obj/structure/St_Muh_13/soil/tropa{tag = "icon-POVOROT2222"; icon_state = "POVOROT2222"},/turf/simulated/floor/St_Muh_13/digable/grass,/area/St_Muh_13/outdoor)
"at" = (/obj/structure/St_Muh_13/soil/tropa{tag = "icon-road_s33"; icon_state = "road_s33"},/obj/item/device/flashlight/flare,/turf/simulated/floor/St_Muh_13/digable/grass,/area/St_Muh_13/outdoor)
"au" = (/turf/simulated/wall,/area/St_Muh_13/outdoor)
"av" = (/turf/simulated/wall/silver,/area/St_Muh_13)
"aw" = (/turf/simulated/wall/silvergold,/area/St_Muh_13)
"ax" = (/turf/simulated/wall/voxshuttle,/area/St_Muh_13)
"ay" = (/obj/structure/St_Muh_13/soil/tropa{tag = "icon-road_s3"; icon_state = "road_s3"},/obj/effect/landmark{name = "JoinLate"},/turf/simulated/floor/St_Muh_13/digable/grass,/area/St_Muh_13/outdoor)
"az" = (/obj/item/device/flashlight/slime,/turf/simulated/floor/St_Muh_13/digable/grass,/area/St_Muh_13/outdoor)
"aA" = (/turf/simulated/wall/wood,/area/St_Muh_13/outdoor)
"aB" = (/turf/simulated/wall/brick_wall,/area/St_Muh_13/outdoor)
"aC" = (/turf/simulated/wall/cult,/area/St_Muh_13)
"aD" = (/obj/item/device/flashlight/flare,/turf/simulated/floor/St_Muh_13/digable/grass,/area/St_Muh_13)
"aE" = (/obj/structure/St_Muh_13/soil/tropa{tag = "icon-road_s3"; icon_state = "road_s3"},/obj/item/device/flashlight/flare,/turf/simulated/floor/St_Muh_13/digable/grass,/area/St_Muh_13/outdoor)
"aF" = (/obj/structure/St_Muh_13/soil/tropa{tag = "icon-road144"; icon_state = "road144"},/obj/item/device/flashlight/lantern,/turf/simulated/floor/St_Muh_13/digable/grass,/area/St_Muh_13/outdoor)
"aG" = (/obj/structure/St_Muh_13/soil/tropa{tag = "icon-road_s3333"; icon_state = "road_s3333"},/obj/effect/landmark{name = "JoinLate"},/turf/simulated/floor/St_Muh_13/digable/grass,/area/St_Muh_13/outdoor)
"aH" = (/obj/structure/St_Muh_13/soil/tropa{tag = "icon-road_s3333"; icon_state = "road_s3333"},/obj/item/device/flashlight/flare,/turf/simulated/floor/St_Muh_13/digable/grass,/area/St_Muh_13/outdoor)
"aI" = (/turf/simulated/wall/diamond,/area/St_Muh_13)
"aJ" = (/obj/structure/St_Muh_13/soil/tropa{tag = "icon-POVOROT222"; icon_state = "POVOROT222"},/turf/simulated/floor/St_Muh_13/digable/grass,/area/St_Muh_13)
"aK" = (/obj/structure/St_Muh_13/soil/tropa{tag = "icon-road_s333"; icon_state = "road_s333"},/obj/item/device/flashlight/lantern,/turf/simulated/floor/St_Muh_13/digable/grass,/area/St_Muh_13/outdoor)
"aL" = (/turf/simulated/wall/elevator,/area/St_Muh_13)
"aM" = (/obj/item/device/flashlight,/turf/simulated/floor/St_Muh_13/digable/grass,/area/St_Muh_13)
"aN" = (/obj/effect/landmark/start,/turf/simulated/floor/St_Muh_13/digable/grass,/area/St_Muh_13)
"aO" = (/obj/item/device/flashlight/lamp/green,/turf/simulated/floor/St_Muh_13/digable/grass,/area/St_Muh_13)
"aP" = (/turf/simulated/wall/gold,/area/St_Muh_13)
"aQ" = (/obj/item/device/flashlight/lantern,/turf/simulated/floor/St_Muh_13/digable/grass,/area/St_Muh_13)
"aR" = (/turf/simulated/wall/uranium,/area/St_Muh_13)
"aS" = (/turf/simulated/wall/golddiamond,/area/St_Muh_13)
"aT" = (/turf/simulated/wall/titanium,/area/St_Muh_13)
"aU" = (/turf/simulated/wall/iron,/area/St_Muh_13)
"aV" = (/turf/simulated/wall/phoron,/area/St_Muh_13)
"aW" = (/turf/simulated/wall/ocp_wall,/area/St_Muh_13)
"aX" = (/turf/simulated/wall/ironphoron,/area/St_Muh_13)
"aY" = (/turf/simulated/wall/r_wall,/area/St_Muh_13)
"aZ" = (/turf/simulated/wall/sandstone,/area/St_Muh_13)
"ba" = (/turf/simulated/wall/sandstonediamond,/area/St_Muh_13)

(1,1,1) = {"
aaaaaaaaaaaaaaaaaaaaaaaaaaaaaaaaaaaaaaaaaaaaaaaaaaaaaaaaaaaaaaaaaaaaaaaaaaaaaaaaaaaaaaaaaaaaaaaaaaaa
aaaaaaaaaaaaaaaaaaaaaaaaaaaaaaaaaaaaaaaaaaaaaaaaaaaaaaaaaaaaaaaaaaaaaaaaaaaaaaaaaaaaaaaaaaaaaaaaaaaa
aaaaaaaaaaaaaaaaaaaaaaaaaaaaaaaaaaaaaaaaaaaaaaaaaaaaaaaaaaaaaaaaaaaaaaaaaaaaaaaaaaaaaaaaaaaaaaaaaaaa
aaaaaaaaaaaaaaaaaaaaaaaaaaaaaaaaaaaaaaaaaaaaaaaaaaaaaaaaaaaaaaaaaaaaaaaaaaaaaaaaaaaaaaaaaaaaaaaaaaaa
aaaaaaaaaaaaaaaaaaaaaaaaaaaaaaaaaaaaaaaaaaaaaaaaaaaaaaaaaaaaaaaaaaaaaaaaaaaaaaaaaaaaaaaaaaaaaaaaaaaa
aaaaaaaaaaaaaaaaaaaaaaaaaaaaaaaaaaaaaaaaaaaaaaaaaaaaaaaaaaaaaaaaaaaaaaaaaaaaaaaaaaaaaaaaaaaaaaaaaaaa
aaaaaaaaaaaaaaaaaaaaaaaaaaaaaaaaaaaaaaaaaaaaaaaaaaaaaaaaaaaaaaaaaaaaaaaaaaaaaaaaaaaaaaaaaaaaaaaaaaaa
aaaaaaaaaaaaaaaaaaaaaaaaaaaaaaaaaaaaaaaaaaaaaaaaaaaaaaaaaaaaaaaaaaaaaaaaaaaaaaaaaaaaaaaaaaaaaaaaaaaa
aaaaaaaaaaaaaaaaaaaaaaaaaaaaaaaaaaaaaaaaaaaaaaaaaaaaaaaaaaaaaaaaaaaaaaaaaaaaaaaaaaaaaaaaaaaaaaaaaaaa
aaaaaaaaaaaaaaaaaaaaaaaaaaaaaaaaaaaaaaaaaaaaaaaaaaaaaaaaaaaaaaaaaaaaaaaaaaaaaaaaaaaaaaaaaaaaaaaaaaaa
aaaaaaaaaaaaaaaaaaaaaaaaaaaaaaaaaaaaaaaaaaaaaaaaaaaaaaaaaaaaaaaaaaaaaaaaaaaaaaaaaaaaaaaaaaaaaaaaaaaa
aaaaaaaaaaaaaaaaaaaaaaaaaaaaaaaaaaaaaaaaaaaaaaaaaaaaaaaaaaaaaaaaaaaaaaaaaaaaaaaaaaaaaaaaaaaaaaaaaaaa
aaaaaaaaaaaaaaaaaaaaaaaaaaaaaaaaaaaaaaaaaaaaaaaaaaaaaaaaaaaaaaaaaaaaaaaaaaaaaaaaaaaaaaaaaaaaaaaaaaaa
aaabababababababababababababababababababababababababababababababababababaaaaaaaaaaaaaaaaaaaaaaaaaaaa
aaabacacacacacacacacacacacacacacacacacacacacacacacacacacacacacacacacacabaaaaaaaaaaaaaaaaaaaaaaaaaaaa
aaabacacacacacacacacacacacacacacacacacacacacacacacacacacacacacacacacacabaaaaaaaaaaaaaaaaaaaaaaaaaaaa
aaabacacacacacacacacacacacacacacacacacacacacacacacacacacacacacacacacacabaaaaaaaaaaaaaaaaaaaaaaaaaaaa
aaabacacacacacacacacacacacacacacacacacacacacacacacacacacacacacacacacacabaaaaaaaaaaaaaaaaaaaaaaaaaaaa
aaabacacacacacacacacacacacacacacacacacacacacacacacacacacacacacacacacacabaaaaaaaaaaaaaaaaaaaaaaaaaaaa
aaabacacacacacacacacacacacacacacacacacacacacacacacacacacacacacacacacacabaaaaaaaaaaaaaaaaaaaaaaaaaaaa
aaabacacacacacacacacacacacacacacacacacacacacacacacacacacacacacacacacacabaaaaaaaaaaaaaaaaaaaaaaaaaaaa
aaabacacacacacacacacacacacacacacacacacacacacacacacacacacacacacacacacacabaaaaaaaaaaaaaaaaaaaaaaaaaaaa
aaabacacacacacacacacacacacacacacacacacacacacacacacacacacacacacacacacacabaaaaaaaaaaaaaaaaaaaaaaaaaaaa
aaabacacacacacacacacacacacacacacacacacacacabadadabacacacacacacacacacacabaaaaaaaaaaaaaaaaaaaaaaaaaaaa
aaabacacacacacacacacacacacacacacacacacacacabacacabacacacacacacacacacacabaaaaaaaaaaaaaaaaaaaaaaaaaaaa
aaabacacacacacacacacacacacacacacacacacacacabacacabacacacacacacacacacacabaaaaaaaaaaaaaaaaaaaaaaaaaaaa
aaababababababababababababaeababababafabababadadababababababababababababaaaaaaaaaaaaaaaaaaaaaaaaaaaa
aaaaaaaaaaaaaaaaaaaaaaaaaaaaaaaaaaaaaaaaaaagahaiagaaajaaaaaaaaaaaaaaaaaaaaaaaaaaaaaaaaaaaaaaaaaaaaaa
aaaaaaaaaaaaaaaaaaaaaaaaaaaaaaaaaaaaaaaaaaaaahaiaaaaaaaaaaaaaaaaaaaaaaaaaaaaaaaaaaaaaaaaaaaaaaaaaaaa
aaaaaaaaaaaaaaaaaaaaaaaaaaaaaaaaaaaaaaajaaaaahaiaaaaaaaaaaaaaaaaaaaaaaaaaaaaaaaaaaaaaaaaaaaaaaaaaaaa
aaaaaaaaaaaaaaaaaaaaaaaaaaaaaaaaaaaaaaaaaaaaahaiaaaaaaaaaaaaaaaaaaaaaaaaaaaaaaaaaaaaaaaaaaaaaaaaaaaa
aaaaaaaaaaaaaaaaaaaaaaaaaaaaaaaaaaaaaaaaaaaaahaiaaaaaaaaaaaaaaaaaaaaaaaaaaaaaaaaaaaaaaaaaaaaaaaaaaaa
aaaaaaaaaaaaaaaaaaaaaaaaaaaaaaaaaaaaaaaaaaaaahaiaaaaaaaaaaaaaaaaaaaaaaaaaaaaaaaaaaaaaaaaaaaaaaaaaaaa
aaaaaaaaaaaaaaaaaaaaaaaaaaaaaaaaaaaaaaaaaaaaahaiaaaaaaaaaaaaaaaaaaaaaaaaaaaaaaaaaaaaaaaaaaaaaaaaaaaa
aaaaaaaaaaaaaaakalalalalalamaaaaaaaaaaaaaaaaahaiaaaaaaaaaaaaaaaaaaaaaaaaaaaaaaaaaaaaaaaaaaaaaaaaaaaa
aaaaaaaaaaaaaaahanaoaoaoapaqalalalalalalalalaraiaaaaaaaaaaaaaaaaaaaaaaaaaaaaaaaaaaaaaaaaaaaaaaaaaaaa
aaaaaaaaaaaaaaahaiaaaaaaahanaoaoaoaoaoaoaoaoaoasaaaaaaaaaaaaaaaaaaaaaaaaaaaaaaaaaaaaaaaaaaaaaaaaaaaa
aaaaaaaaaaaaaaahaiaaaaaaahaiaaaaaaaaaaaaaaaaaaaaaaaaaaaaaaaaaaaaaaaaaaaaaaaaaaaaaaaaaaaaaaaaaaaaaaaa
aaaaaaaaaaaaaaahaiaaaaaaahaiaaaaaaaaaaaaaaaaaaaaaaaaaaaaaaaaaaaaaaaaaaaaaaaaaaaaaaaaaaaaaaaaaaaaaaaa
aaaaaaaaaaaaaaahataaaaauahaiaaaaaaaaaaaaaaaaaaaaaaaaaaaaaaaaaaaaaaaaaaaaaaaaaaaaaaaaaaaaaaaaaaaaaaaa
aaaaaaaaavawaxayaiazaAaaahaiaaaBaaaaaaaaaaaaaaaaaaaaaaaaaaaaaaaaaaaaaaaaaaaaaaaaaaaaaaaaaaaaaaaaaaaa
aaaaaaaaaCacaDaEaFalaGaHaraiaaaaaaaaaaaaaaaaaaaaaaaaaaaaaaaaaaaaaaaaaaaaaaaaaaaaaaaaaaaaaaaaaaaaaaaa
aaaaaaaaaIacacaJaoaoaKaoaoasaaaBaaaaaaaaaaaaaaaaaaaaaaaaaaaaaaaaaaaaaaaaaaaaaaaaaaaaaaaaaaaaaaaaaaaa
aaaaaaaaaLacaMaNaOacabaaaaaaaaaBaaaaaaaaaaaaaaaaaaaaaaaaaaaaaaaaaaaaaaaaaaaaaaaaaaaaaaaaaaaaaaaaaaaa
aaaaaaaaaPacacaQaDacaRaaaaaaaBaBaBaaaaaaaaaaaaaaaaaaaaaaaaaaaaaaaaaaaaaaaaaaaaaaaaaaaaaaaaaaaaaaaaaa
aaaaaaaaaSacacacacacaTaaaaaaaaaaaaaaaaaaaaaaaaaaaaaaaaaaaaaaaaaaaaaaaaaaaaaaaaaaaaaaaaaaaaaaaaaaaaaa
aaaaaaaaaUaVaWaXaYaZbaaaaaaaaaaaaaaaaaaaaaaaaaaaaaaaaaaaaaaaaaaaaaaaaaaaaaaaaaaaaaaaaaaaaaaaaaaaaaaa
aaaaaaaaaaaaaaaaaaaaaaaaaaaaaaaaaaaaaaaaaaaaaaaaaaaaaaaaaaaaaaaaaaaaaaaaaaaaaaaaaaaaaaaaaaaaaaaaaaaa
aaaaaaaaaaaaaaaaaaaaaaaaaaaaaaaaaaaaaaaaaaaaaaaaaaaaaaaaaaaaaaaaaaaaaaaaaaaaaaaaaaaaaaaaaaaaaaaaaaaa
aaaaaaaaaaaaaaaaaaaaaaaaaaaaaaaaaaaaaaaaaaaaaaaaaaaaaaaaaaaaaaaaaaaaaaaaaaaaaaaaaaaaaaaaaaaaaaaaaaaa
"}
